60
8
0 0 0 0 0 0 0 0 
6 8 8 20 0 0 0 0 
6 8 8 20 0 0 0 0 
4 10 6 22 0 0 0 0 
4 10 6 22 0 0 0 0 
2 6 2 4 4 24 0 0 
2 6 2 4 4 24 0 0 
2 4 4 4 4 6 2 16 
2 4 4 4 4 6 2 16 
2 4 12 4 4 16 0 0 
2 4 12 4 4 16 0 0 
2 4 12 4 0 0 0 0 
2 4 12 4 0 0 0 0 
2 12 4 4 0 0 0 0 
2 12 4 4 0 0 0 0 
2 12 4 4 4 16 0 0 
2 12 4 4 4 16 0 0 
6 8 6 22 0 0 0 0 
6 8 6 22 0 0 0 0 
6 8 6 22 0 0 0 0 
6 8 6 22 0 0 0 0 
2 12 4 8 0 0 0 0 
2 12 4 8 0 0 0 0 
2 12 4 16 0 0 0 0 
2 12 4 16 0 0 0 0 
2 4 4 26 2 4 0 0 
2 4 4 26 2 4 0 0 
1 7 2 16 2 8 2 4 
1 7 2 16 2 8 2 4 
1 7 4 14 2 2 2 10 
1 7 4 14 2 2 2 10 
1 7 6 10 4 2 4 8 
1 7 6 10 4 2 4 8 
2 6 20 2 0 0 0 0 
2 6 20 2 0 0 0 0 
2 7 18 3 0 0 0 0 
2 7 17 4 0 0 0 0 
3 7 11 4 1 4 0 0 
3 7 10 10 0 0 0 0 
4 7 9 10 0 0 0 0 
4 7 9 9 0 0 0 0 
3 9 8 2 1 3 0 0 
3 9 8 2 1 2 0 0 
2 3 1 7 7 2 0 0 
2 3 1 7 7 2 0 0 
1 3 3 7 4 6 0 0 
1 3 3 7 3 8 0 0 
2 3 3 7 2 8 0 0 
2 3 3 7 2 8 0 0 
1 3 5 16 0 0 0 0 
1 3 5 16 0 0 0 0 
2 3 5 15 0 0 0 0 
2 3 5 14 0 0 0 0 
14 5 0 0 0 0 0 0 
14 5 0 0 0 0 0 0 
14 4 0 0 0 0 0 0 
14 4 0 0 0 0 0 0 
15 2 0 0 0 0 0 0 
15 2 0 0 0 0 0 0 
0 0 0 0 0 0 0 0 
