100
15
17 0 0 0 0 0 0 0 0 0 0 0 0 0 0 
17 0 0 0 0 0 0 0 0 0 0 0 0 0 0 
17 0 0 0 0 0 0 0 0 0 0 0 0 0 0 
17 0 0 0 0 0 0 0 0 0 0 0 0 0 0 
16 0 0 0 0 0 0 0 0 0 0 0 0 0 0 
16 57 1 0 0 0 0 0 0 0 0 0 0 0 0 
16 56 2 0 0 0 0 0 0 0 0 0 0 0 0 
16 56 2 0 0 0 0 0 0 0 0 0 0 0 0 
15 57 2 0 0 0 0 0 0 0 0 0 0 0 0 
15 57 2 0 0 0 0 0 0 0 0 0 0 0 0 
15 58 1 0 0 0 0 0 0 0 0 0 0 0 0 
15 0 0 0 0 0 0 0 0 0 0 0 0 0 0 
14 0 0 0 0 0 0 0 0 0 0 0 0 0 0 
14 0 0 0 0 0 0 0 0 0 0 0 0 0 0 
14 0 0 0 0 0 0 0 0 0 0 0 0 0 0 
14 19 1 0 0 0 0 0 0 0 0 0 0 0 0 
13 19 2 0 0 0 0 0 0 0 0 0 0 0 0 
13 19 2 37 1 0 0 0 0 0 0 0 0 0 0 
13 19 2 36 2 0 0 0 0 0 0 0 0 0 0 
12 20 2 36 2 0 0 0 0 0 0 0 0 0 0 
12 21 1 36 2 0 0 0 0 0 0 0 0 0 0 
11 59 2 0 0 0 0 0 0 0 0 0 0 0 0 
11 60 1 0 0 0 0 0 0 0 0 0 0 0 0 
10 19 1 0 0 0 0 0 0 0 0 0 0 0 0 
10 18 2 0 0 0 0 0 0 0 0 0 0 0 0 
9 19 2 7 1 0 0 0 0 0 0 0 0 0 0 
9 19 2 6 2 0 0 0 0 0 0 0 0 0 0 
8 20 2 6 2 0 0 0 0 0 0 0 0 0 0 
8 21 1 6 2 0 0 0 0 0 0 0 0 0 0 
8 28 2 15 1 19 1 0 0 0 0 0 0 0 0 
8 29 1 14 2 18 2 0 0 0 0 0 0 0 0 
10 42 2 18 2 0 0 0 0 0 0 0 0 0 0 
12 40 2 18 2 0 0 0 0 0 0 0 0 0 0 
14 38 2 18 2 0 0 0 0 0 0 0 0 0 0 
14 39 1 19 1 0 0 0 0 0 0 0 0 0 0 
13 3 1 10 1 0 0 0 0 0 0 0 0 0 0 
13 3 2 8 2 0 0 0 0 0 0 0 0 0 0 
12 4 3 7 2 11 1 0 0 0 0 0 0 0 0 
12 4 4 6 2 10 2 0 0 0 0 0 0 0 0 
11 4 6 5 2 10 2 9 1 7 1 0 0 0 0 
11 4 6 6 1 10 2 8 2 6 2 0 0 0 0 
10 4 8 16 2 8 2 6 2 13 1 0 0 0 0 
10 4 8 17 1 8 2 6 2 12 2 0 0 0 0 
9 4 9 26 2 6 2 12 2 0 0 0 0 0 0 
9 4 9 27 1 7 1 12 2 0 0 0 0 0 0 
8 4 9 49 2 0 0 0 0 0 0 0 0 0 0 
8 4 9 50 1 0 0 0 0 0 0 0 0 0 0 
7 4 9 5 1 17 1 0 0 0 0 0 0 0 0 
7 4 8 5 2 16 2 0 0 0 0 0 0 0 0 
6 4 8 6 2 16 2 17 1 0 0 0 0 0 0 
6 4 7 7 2 16 2 16 2 0 0 0 0 0 0 
5 4 7 8 2 16 2 16 2 0 0 0 0 0 0 
5 4 5 11 1 17 1 16 2 0 0 0 0 0 0 
4 4 4 48 2 11 1 0 0 0 0 0 0 0 0 
4 4 2 51 1 10 2 0 0 0 0 0 0 0 0 
3 69 2 0 0 0 0 0 0 0 0 0 0 0 0 
3 69 2 0 0 0 0 0 0 0 0 0 0 0 0 
2 27 1 42 2 0 0 0 0 0 0 0 0 0 0 
2 26 2 43 1 0 0 0 0 0 0 0 0 0 0 
2 26 2 15 1 0 0 0 0 0 0 0 0 0 0 
2 26 2 14 2 0 0 0 0 0 0 0 0 0 0 
2 26 2 14 2 0 0 0 0 0 0 0 0 0 0 
2 27 1 14 2 0 0 0 0 0 0 0 0 0 0 
2 42 2 0 0 0 0 0 0 0 0 0 0 0 0 
2 43 1 0 0 0 0 0 0 0 0 0 0 0 0 
5 30 1 35 1 0 0 0 0 0 0 0 0 0 0 
6 28 2 34 2 0 0 0 0 0 0 0 0 0 0 
6 5 3 20 2 34 2 0 0 0 0 0 0 0 0 
6 4 8 16 2 34 2 0 0 0 0 0 0 0 0 
6 4 12 12 2 34 2 0 0 0 0 0 0 0 0 
6 4 14 11 1 35 1 0 0 0 0 0 0 0 0 
6 4 15 0 0 0 0 0 0 0 0 0 0 0 0 
6 4 16 0 0 0 0 0 0 0 0 0 0 0 0 
6 4 16 0 0 0 0 0 0 0 0 0 0 0 0 
6 4 17 0 0 0 0 0 0 0 0 0 0 0 0 
6 4 6 1 10 0 0 0 0 0 0 0 0 0 0 
6 4 5 3 9 0 0 0 0 0 0 0 0 0 0 
6 4 5 3 9 10 1 7 1 7 1 7 1 7 1 
6 4 6 3 9 8 2 6 2 6 2 6 2 6 2 
6 4 6 3 9 8 2 6 2 6 2 6 2 6 2 
6 14 8 8 2 6 2 6 2 6 2 6 2 0 0 
6 14 8 8 2 6 2 6 2 6 2 6 2 0 0 
6 4 8 3 8 8 1 7 1 7 1 7 1 7 1 
6 4 8 3 8 0 0 0 0 0 0 0 0 0 0 
6 4 9 3 7 0 0 0 0 0 0 0 0 0 0 
6 4 9 3 7 0 0 0 0 0 0 0 0 0 0 
6 4 10 3 5 0 0 0 0 0 0 0 0 0 0 
6 4 10 3 5 13 1 7 1 7 1 7 1 0 0 
6 4 11 3 3 13 2 6 2 6 2 6 2 0 0 
6 4 11 3 3 13 2 6 2 6 2 6 2 0 0 
6 4 12 3 1 4 1 9 2 6 2 6 2 6 2 
6 4 12 3 1 4 1 9 2 6 2 6 2 6 2 
6 4 13 6 2 10 1 7 1 7 1 7 1 0 0 
6 4 13 6 2 0 0 0 0 0 0 0 0 0 0 
6 4 14 4 4 0 0 0 0 0 0 0 0 0 0 
6 4 14 4 4 0 0 0 0 0 0 0 0 0 0 
6 4 15 2 5 0 0 0 0 0 0 0 0 0 0 
6 4 22 0 0 0 0 0 0 0 0 0 0 0 0 
6 4 22 0 0 0 0 0 0 0 0 0 0 0 0 
6 4 22 0 0 0 0 0 0 0 0 0 0 0 0 
