80
10
0 0 0 0 0 0 0 0 0 0 
0 0 0 0 0 0 0 0 0 0 
0 0 0 0 0 0 0 0 0 0 
0 0 0 0 0 0 0 0 0 0 
0 0 0 0 0 0 0 0 0 0 
0 0 0 0 0 0 0 0 0 0 
0 0 0 0 0 0 0 0 0 0 
5 2 10 2 0 0 0 0 0 0 
3 6 6 6 0 0 0 0 0 0 
3 2 2 2 6 2 2 2 0 0 
2 2 4 2 4 2 4 2 0 0 
2 2 4 2 4 2 4 2 0 0 
3 2 4 2 2 2 5 2 0 0 
3 2 4 6 5 4 0 0 0 0 
3 2 6 2 7 5 0 0 0 0 
2 4 12 8 0 0 0 0 0 0 
2 4 10 11 0 0 0 0 0 0 
3 2 9 4 2 8 0 0 0 0 
14 2 6 7 0 0 0 0 0 0 
14 2 8 6 0 0 0 0 0 0 
13 4 8 6 0 0 0 0 0 0 
13 4 9 6 0 0 0 0 0 0 
14 2 10 6 0 0 0 0 0 0 
27 6 0 0 0 0 0 0 0 0 
27 6 0 0 0 0 0 0 0 0 
27 6 0 0 0 0 0 0 0 0 
13 2 12 6 0 0 0 0 0 0 
12 4 10 6 0 0 0 0 0 0 
12 4 10 6 0 0 0 0 0 0 
13 2 10 6 0 0 0 0 0 0 
13 2 9 6 0 0 0 0 0 0 
13 2 7 7 0 0 0 0 0 0 
12 4 4 8 0 0 0 0 0 0 
12 6 2 7 0 0 0 0 0 0 
11 2 3 10 0 0 0 0 0 0 
11 2 5 7 0 0 0 0 0 0 
10 2 8 4 0 0 0 0 0 0 
8 4 8 4 0 0 0 0 0 0 
6 4 10 5 0 0 0 0 0 0 
6 2 12 6 0 0 0 0 0 0 
5 2 14 6 0 0 0 0 0 0 
4 4 14 6 0 0 0 0 0 0 
4 4 14 6 0 0 0 0 0 0 
5 2 14 6 0 0 0 0 0 0 
20 6 0 0 0 0 0 0 0 0 
20 5 0 0 0 0 0 0 0 0 
20 4 0 0 0 0 0 0 0 0 
8 2 10 4 0 0 0 0 0 0 
6 6 8 4 0 0 0 0 0 0 
6 2 2 4 6 4 0 0 0 0 
5 2 5 2 6 4 0 0 0 0 
5 2 6 2 5 4 0 0 0 0 
5 2 6 2 5 4 0 0 0 0 
4 4 6 2 4 4 0 0 0 0 
4 4 6 4 2 4 0 0 0 0 
5 2 9 8 0 0 0 0 0 0 
16 8 0 0 0 0 0 0 0 0 
14 4 2 4 8 2 0 0 0 0 
12 4 4 4 7 4 0 0 0 0 
10 4 6 4 7 4 0 0 0 0 
10 2 8 4 7 4 0 0 0 0 
3 2 4 2 10 4 6 4 0 0 
2 4 3 2 10 4 6 4 0 0 
2 4 2 4 9 4 6 4 0 0 
3 2 3 4 9 4 6 4 0 0 
3 2 2 3 1 2 9 4 4 4 
3 7 1 2 9 4 4 4 0 0 
5 2 1 2 2 2 9 4 2 4 
8 2 2 4 8 8 0 0 0 0 
8 2 4 2 9 6 0 0 0 0 
7 4 4 2 9 4 0 0 0 0 
7 4 4 2 10 2 0 0 0 0 
8 2 6 2 0 0 0 0 0 0 
16 2 0 0 0 0 0 0 0 0 
16 2 0 0 0 0 0 0 0 0 
15 4 0 0 0 0 0 0 0 0 
15 4 0 0 0 0 0 0 0 0 
16 2 0 0 0 0 0 0 0 0 
0 0 0 0 0 0 0 0 0 0 
0 0 0 0 0 0 0 0 0 0 
