86
3
0
S1 E0 E0 
S1 E0 E0 
S1 E0 E0 
S1 E0 E0 
S1 E0 E0 
S1 E0 E0 
S1 E0 E0 
S1 E0 E0 
S1 E33 S10 
S1 E33 S10 
S1 E33 S2 
S1 E33 S2 
S1 E33 S2 
S1 E33 S2 
S1 E0 E0 
S1 E0 E0 
S1 E0 E0 
S1 E0 E0 
S2 E0 E0 
S2 E0 E0 
S3 E0 E0 
S3 E0 E0 
S4 E28 S2 
S4 E28 S2 
S4 E28 S2 
S4 E28 S2 
S1 E2 S1 
S1 E2 S1 
S1 E2 S1 
S1 E2 S1 
S1 E29 S2 
S1 E29 S2 
S1 E29 S2 
S1 E29 S2 
S1 E0 E0 
S2 E0 E0 
S3 E0 E0 
S4 E0 E0 
S4 E4 S24 
S4 E4 S24 
S4 E4 S24 
S4 E4 S24 
S4 E8 S20 
S4 E8 S20 
S4 E4 S24 
S4 E4 S24 
S4 E6 S22 
S4 E6 S22 
S4 E8 S20 
S4 E8 S20 
S6 E8 S20 
S6 E8 S20 
S8 E8 S20 
S8 E8 S20 
S10 E8 S14 
S10 E8 S14 
S12 E8 S12 
S12 E8 S12 
S14 E8 S12 
S14 E8 S12 
S16 E8 S6 
S16 E8 S6 
S18 E8 S4 
S18 E8 S4 
S20 E8 S4 
S20 E8 S4 
S22 E8 S2 
S22 E8 S2 
S24 E6 S2 
S24 E6 S2 
S24 E6 S2 
S24 E6 S2 
S28 E0 E0 
S28 E0 E0 
S20 E6 S2 
S20 E6 S2 
S20 E0 E0 
S20 E0 E0 
S20 E2 S2 
S20 E2 S2 
S24 E0 E0 
S24 E0 E0 
S26 E0 E0 
S26 E0 E0 
S26 E0 E0 
S26 E0 E0 
