86
7
0
S1 E0 E0 E0 E0 E0 E0 
S1 E0 E0 E0 E0 E0 E0 
S1 E0 E0 E0 E0 E0 E0 
S1 E0 E0 E0 E0 E0 E0 
S1 E0 E0 E0 E0 E0 E0 
S1 E0 E0 E0 E0 E0 E0 
S1 E0 E0 E0 E0 E0 E0 
S1 E0 E0 E0 E0 E0 E0 
S1 E33 S10 E0 E0 E0 E0 
S1 E32 B1 S10 E0 E0 E0 
S1 E31 B2 S2 B6 E0 E0 
S1 E31 B2 S2 B1 E1 B2 
S1 E32 B1 S2 B2 E0 E0 
S1 E33 S2 E0 E0 E0 E0 
S1 E0 E0 E0 E0 E0 E0 
S1 E0 E0 E0 E0 E0 E0 
S1 E0 E0 E0 E0 E0 E0 
S1 E0 E0 E0 E0 E0 E0 
S2 E0 E0 E0 E0 E0 E0 
S2 E0 E0 E0 E0 E0 E0 
S3 E0 E0 E0 E0 E0 E0 
S3 E0 E0 E0 E0 E0 E0 
S4 E28 S2 E0 E0 E0 E0 
S4 E27 B1 S2 E0 E0 E0 
S4 E27 B1 S2 E0 E0 E0 
S4 E28 S2 E0 E0 E0 E0 
S1 E1 B1 S1 E0 E0 E0 
S1 E2 S1 E0 E0 E0 E0 
S1 E2 S1 E0 E0 E0 E0 
S1 E2 S1 E0 E0 E0 E0 
S1 E29 S2 E0 E0 E0 E0 
S1 E28 B1 S2 E0 E0 E0 
S1 E28 B1 S2 E0 E0 E0 
S1 E29 S2 E0 E0 E0 E0 
S1 E0 E0 E0 E0 E0 E0 
S2 E0 E0 E0 E0 E0 E0 
S3 E0 E0 E0 E0 E0 E0 
S4 E0 E0 E0 E0 E0 E0 
S4 E4 S24 E0 E0 E0 E0 
S4 E3 B1 S24 E0 E0 E0 
S4 E2 B2 S24 E0 E0 E0 
S4 B4 S24 E0 E0 E0 E0 
S4 B5 E2 B1 S20 E0 E0 
S4 B6 E2 S20 E0 E0 E0 
S4 B4 S24 E0 E0 E0 E0 
S4 B4 S24 E0 E0 E0 E0 
S4 B6 S22 E0 E0 E0 E0 
S4 B6 S22 E0 E0 E0 E0 
S4 B8 S20 E0 E0 E0 E0 
S4 B4 E2 B2 S20 E0 E0 
S6 B2 E3 B3 S20 E0 E0 
S6 B3 E2 B3 S20 E0 E0 
S8 B8 S20 E0 E0 E0 E0 
S8 B8 S20 E0 E0 E0 E0 
S10 B4 E1 B3 S14 B3 E0 
S10 B4 E2 B2 S14 B3 E0 
S12 B2 E3 B3 S12 B2 E0 
S12 B3 E3 B2 S12 B2 E0 
S14 B2 E2 B4 S12 E0 E0 
S14 B3 E1 B4 S12 E0 E0 
S16 B8 S6 B3 E0 E0 E0 
S16 B8 S6 B3 E0 E0 E0 
S18 B3 E2 B3 S4 B2 E0 
S18 B3 E3 B2 S4 B2 E0 
S20 B2 E2 B4 S4 E0 E0 
S20 B8 S4 E0 E0 E0 E0 
S22 B8 S2 E0 E0 E0 E0 
S22 B8 S2 E0 E0 E0 E0 
S24 E3 B3 S2 E0 E0 E0 
S24 E5 B1 S2 E0 E0 E0 
S24 E6 S2 E0 E0 E0 E0 
S24 B1 E5 S2 E0 E0 E0 
S28 E0 E0 E0 E0 E0 E0 
S28 E0 E0 E0 E0 E0 E0 
S20 B6 S2 E0 E0 E0 E0 
S20 B6 S2 E0 E0 E0 E0 
S20 B3 E0 E0 E0 E0 E0 
S20 B3 E0 E0 E0 E0 E0 
S20 E1 B1 S2 E0 E0 E0 
S20 E2 S2 E0 E0 E0 E0 
S24 E0 E0 E0 E0 E0 E0 
S24 E0 E0 E0 E0 E0 E0 
S26 E0 E0 E0 E0 E0 E0 
S26 E0 E0 E0 E0 E0 E0 
S26 E0 E0 E0 E0 E0 E0 
S26 E0 E0 E0 E0 E0 E0 
