80
7
38 0 0 0 0 0 0 
37 0 0 0 0 0 0 
36 0 0 0 0 0 0 
35 0 0 0 0 0 0 
35 0 0 0 0 0 0 
32 0 0 0 0 0 0 
31 0 0 0 0 0 0 
30 0 0 0 0 0 0 
30 0 0 0 0 0 0 
30 0 0 0 0 0 0 
27 8 5 0 0 0 0 
26 9 5 0 0 0 0 
25 10 6 0 0 0 0 
26 9 7 0 0 0 0 
27 8 8 0 0 0 0 
30 0 0 0 0 0 0 
30 0 0 0 0 0 0 
30 0 0 0 0 0 0 
30 0 0 0 0 0 0 
30 0 0 0 0 0 0 
17 23 5 0 0 0 0 
16 24 5 0 0 0 0 
15 25 6 0 0 0 0 
15 25 7 0 0 0 0 
15 25 8 0 0 0 0 
12 0 0 0 0 0 0 
11 0 0 0 0 0 0 
10 0 0 0 0 0 0 
10 0 0 0 0 0 0 
10 0 0 0 0 0 0 
7 8 5 20 10 0 0 
6 9 5 20 10 0 0 
5 10 5 20 10 0 0 
5 10 6 19 10 0 0 
5 10 7 18 10 0 0 
5 10 10 15 7 0 0 
5 10 10 15 6 0 0 
5 10 10 15 5 0 0 
6 9 10 15 5 0 0 
7 8 10 15 5 0 0 
10 40 5 0 0 0 0 
10 40 5 0 0 0 0 
10 40 5 0 0 0 0 
11 39 5 0 0 0 0 
12 38 5 0 0 0 0 
15 10 5 5 5 10 5 
15 10 5 5 5 10 5 
15 10 5 5 5 10 5 
15 10 5 5 5 10 5 
15 10 5 5 5 10 5 
7 1 7 0 0 0 0 
6 3 6 0 0 0 0 
5 5 5 0 0 0 0 
5 5 5 0 0 0 0 
5 5 5 0 0 0 0 
5 5 5 15 5 10 8 
5 5 5 15 5 10 7 
5 5 5 15 5 10 6 
5 5 5 15 5 10 5 
5 5 5 15 5 10 5 
5 25 5 10 5 0 0 
5 25 5 10 5 0 0 
5 25 5 10 5 0 0 
6 24 5 10 5 0 0 
7 23 5 10 5 0 0 
10 10 5 5 5 10 5 
10 10 5 5 5 10 5 
10 10 5 5 5 10 5 
11 9 5 5 5 10 5 
12 8 5 5 5 10 5 
15 15 5 10 5 0 0 
15 15 5 10 5 0 0 
15 15 5 10 5 0 0 
16 13 6 10 5 0 0 
17 11 7 10 5 0 0 
20 5 10 10 5 0 0 
20 5 10 10 5 0 0 
20 5 10 10 5 0 0 
21 3 12 8 7 0 0 
22 1 14 6 9 0 0 
